* **************
* **     *   * *
*  * ***   * * *
** *   ** *  * *
*    * *  * *  *
* * *  ***** * *
* *** **       *
*   ***  * * ***
* * *   ** * * *
* * * **  *    *
* * *   * ** ***
* *****   *    *
*     *** * ** *
*** * * * * *  *
*   *     *  * *
************** *