* **********
* **     ***
*  * *   * *
*      *   *
*   *   * **
**   ** *  *
*    ** *  *
* *   * * **
***   *  * *
*     *    *
*     *   **
******* ****